xxxxxxxxxxxxxxxxxxxxxxxxxxxxxxxxxxxxxxxxxxxxxxxxxxxxxxxxxxxxxxxxxxxxxxxxxxxxxxxxxxxxxxxxxxxxxxxxxxxxxxxxxx
x                         x                               x                               x              x
x            E            x          E       E            x         E        E            x       E      x
x                         x                               x                               x              x
x     E                   x                        E      x                               x       E      x
x                         x  E                            x                          E    x     E        x
x                    E    x                               x                               x              x
x          E              x                               x                               x              x
x S                       x           E    S              x   E                           x    E         x
x         x               x               x        E      x               x     E         x              x
x         x               x               x               x               x               x         E    x
x         x    E          x               x               x             E x         E     x              x
x         x               x E             x               x               x               x              x
x         x               x               x         E     x               x               x     E        x
x         x               x               x               x               x     E         x         E    x
xE        x      E        x          E    x               x      E        x               x              x
x         x               x    E          x               x               x               x              x
x         x               x               x       E       x               x               x              x
x         x               x               x               x        E      x            E  x              x
x         x               x               x               x               x               x              x
x         x     E         x               x               x               x    E          x      E       x
x         x               x     E         x      E        x               x               x              x
x         x               x               x               x    E          x               x              x
x   E     x               x               x               x               x               x        E     x
x         x               x               x               x               x            E  x              x
x         x               x               x               x               x               x              x
x         x               x               x E             x      E        x               x              x
xE        x     E         x               x               x               x               x     E        x
x         x               x               x       E       x               x   E           x              x
x         x               x      E        x               xE              x        E      x              x
x         x E             x               x               x               x               x              x
x   E     x         E     x     E         x      E        x               x           E   x              x
x         x               x               x               x               x               x              x
x         x               x               x               x               x               x              x
x         x               x           E   x               x             E x               x              x
x         x E             x               x               x               x           E   x         E    x
x    E    x               x               x               x     E         x               x              x
x         x               x        E      x       E       x               x               x              x
x         x               x               x               x               x               x              x
x         x               x               x               x               x               x E            x
x         x               x               x               x         E     x               x              x
x         x     E         x               x               x               x       E       x              x
x         x               x               x               x               x               x              x
x         x               x               x               x               x               x              x
x         x               x      E        x               x      E        x               x        E     x
x         x               x               x      E        x               x    E          x              x
x         x               x               x               x               x               x E            x
x         x               x               x               x           E   x               x              x
x    E    x       E       x               x               x               x               x              x
x         x               x               x      E        x               x  E            x              x
x         x               x               x               x               x         E     x        E     x
x         x               x               x               x     E         x               x              x
x         x               x               x           E   x               x               x              x
x         x                       E       x                               x                    E         x
x         x         E                     x   E                           x     E                        x
x         x                               x                      E        x                              x
x         x                               x                               x                              x
x       E x                               x        E                      x         E                    x
x         x                               x                          E    x                           E  x
x         x     E                         x                               x                              x
x         x                        E      x           E      E            x                              x
xxxxxxxxxxxxxxxxxxxxxxxxxxxxxxxxxxxxxxxxxxxxxxxxxxxxxxxxxxxxxxxxxxxxxxxxxxxxxxxxxxxxxxxxxxxxxxxxxxxxxxxxxx