xxxxxxxxxxxxxxxxxxxxxxxxxxxxxxxxxxxxxxxxxxxxxxxxxxxxxxxxxxxxxxxxxxxxxxxxxxxxxxxxxxxxxxxxxxxxxxxxxxxxxxxxxx
x              x                               x                           x               x             x
x      E       x                  E            x          E       E        x  E            x       E     x
x                              x                               x                                         x
x              x           E                   x                           x               x       E     x
x                              x                  E            x                      E          E       x
x              x  E                       E    x                           x               x             x
x                              xE                              x                                         x
xE             x       S                       x           E    S          x               x    E        x
x                              x                               x                 E                       x
x       E      x                               x                           x               x         E   x
x               E              x    E                          x         E           E                   x
x              x                               x E                         x               x             x
x         E                    x                               x                                 E       x
x              x                               x                           x     E         x         E   x
x                     E        x      E                   E    x                                         x
x              x                               x    E                      x               x             x
x                              x                               x                                         x
x   E          x                               x                           x            E  x             x
x                              x                               x                                         x
x              x                     E         x                           x    E          x      E      x
x                              x                     E         x      E                                  x
x              x                               x                           x               x             x
x                        E     x                               x                                    E    x
x              x                               x                           x            E  x             x
x                              x                               x                                         x
x              x                               x                 E         x               x             x
x                     E        x     E                         x                                 E       x
x             Ex                               x                           x   E           x             x
x     E                        x                      E        x                    E                    x
x              x                 E             x                           x               x             x
x                        E     x         E           E         x      E                E                 x
x              x                               x                           x               x             x
x                              x                               x                                         x
x              x                               x           E             E x               x             x
x                              x                               x                       E             E   x
x              x          E                    x                           x               x             x
x E                            x                        E      x                                         x
x              x  E                            x                           x               x             x
x                              x                               x                             E           x
x              x                               x                           x               x             x
x         E                    x     E                         x                   E                     x
x              x                               x                           x               x             x
x                    E         x                               x                                         x
x   E          x                               x      E                    x               x        E    x
x                              x                               x      E         E                        x
x              x                               x                           x               x E           x
x                              x                               x       E                                 x
x              x          E            E       x                           x               x             x
x                              x                               x      E       E                          x
x              x                               x                           x         E     x        E    x
x                              x                               x                                         x
x              x   E                           x                           x               x             x
x                              x                       E       x                                E        x
x              x                         E     x                   E       x     E         x             x
x    E                         x                               x                                         x
x              x                               x                           x               x             x
x                    E       E x                               x                     E                   x
x              x                               x                           x               x           E x
x       E                      x     E                         x                                         x
x              x                               x        E                  x               x             x
xxxxxxxxxxxxxxxxxxxxxxxxxxxxxxxxxxxxxxxxxxxxxxxxxxxxxxxxxxxxxxxxxxxxxxxxxxxxxxxxxxxxxxxxxxxxxxxxxxxxxxxxxxx